##########
#........#
#...##.**#
##.####.##
.**....**.
##.####.##
#P.....p.#
#.######.#
#..**+*.B#
##########