#####.**.#
#**.##**.#
##..#***.#
#*..##...#
*****#....
#...*#**.#
##P..##..#
##......##
#.*****..#
####.##.##