##########
#........#
#...##.**#
##.####.##
.**....**.
##.####.##
#P.......#
#.######.#
#..****.B#
##########