##...#########
#...##*****###
#..P######*..#
#***.......###
####...##****#
##...###***..#
##..##...#####
#**####***####
##..##########