##########
#+****p++#
#***##.**#
##.####*##
.**D+****.
##.####.##
#P.**+***#
#*######.#
#+******B#
##########