##...#########
#...##*****###
#..P######*..#
#***......p###
####...##****#
##...###***..#
##..##..B#####
#**####***####
##..##########
#......*****+#
######..######
##.*+..####**#
###..**.######
####.#########