##########
#+****D++#
#***##.**#
##.####*##
.***+****.
##.####.##
#P.**+***#
#*######.#
#+******B#
##########