##########
#********#
##*####*##
##*####*##
**********
##*####*##
#P*****p*#
#*######*#
#*******B#
##########