#####.**.#
#**.##**.#
##..#***.#
#*..##...#
*****#....
#P..*#**.#
###.*##..#
##....B*##
#.*****..#
####.##.##