##########
#......B.#
#...##.**#
##.####.##
.**....**.
##.####.##
#P.......#
#.######.#
#..****..#
##########