#####.**.#
#**.##**.#
##..#***.#
#*..##...#
*****#....
#P..*#**.#
###.*##..#
##......##
#.**B**..#
####.##.##