##########
#........#
#...##.**#
##.####.##
.**....**.
##.####.##
#P..D..p.#
#.S#####.#
#.*****.B#
##########