##########
#........#
#B..##.**#
##.####.##
.**....**.
##.####.##
#P......p#
#.######.#
#..**+*b.#
##########