#####.**.#
#**.##**.#
##..#***.#
#*..##...#
*****#....
#P..*#**.#
###..##..#
##......##
#.*****..#
####.##.##