##########
#........#
#...##.**#
##.####.##
.**....**.
##.####.##
#P.....p.#
#..#####.#
#.*****.B#
##########